LAZ = "countries/Lazaret.txt"
WHS = "countries/Weishnoria.txt"
BSH = "countries/Bashkortostan.txt"
CHK = "countries/Chechkong.txt"
DON = "countries/Donbass.txt"
CHT = "countries/Chat.txt"
CHE = "countries/Chernomorcy.txt"
MOL = "countries/Moldavia.txt"
NOD = "countries/Nod.txt"
ZWN = "countries/Zapweishnoria.txt"
TUP = "countries/Tupichok.txt"
KUR = "countries/Kurginynia.txt"
UNT = "countries/Unts.txt"
MAT = "countries/Morito.txt"
EBN = "countries/Ebengrad.txt"
MGN = "countries/Magnitogorsk.txt"
KAZ = "countries/Kazahstan.txt"
LIM = "countries/Limon.txt"
OMS = "countries/Omsk.txt"
BRT = "countries/Buryatia.txt"
DOT = "countries/Dota.txt"
YSK = "countries/Yuznosibir.txt"
POK = "countries/Pokayania.txt"
MRD = "countries/Mordor.txt"
PRC = "countries/MetacommyChina"
KRR = "countries/Kuban.txt"
VSB = "countries/Vesbariya.txt"
LUB = "countries/Lubeniya.txt"
SPL = "countries/Sprotland.txt"
UKR = "countries/Ukraine.txt"
YUG = "countries/SerbDobrovolec.txt"
MAG = "countries/Magadan.txt"
DLS = "countries/Dark Logos.txt"
ALB = "countries/Albania.txt"
CRI = "countries/Crimea.txt"
STR = "countries/Stavropol.txt"
ARK = "countries/Sever.txt"
BAD = "countries/Badia.txt"
WRO = "countries/Wromania.txt"
MHL = "countries/Mihalkovia.txt"
IIS = "countries/IstIndasris.txt"
TUB = "countries/Tubus.txt"
YWO = "countries/YWolfs.txt"
OSM = "countries/Osman.txt"
TSG = "countries/Tsargrad.txt"
PGR = "countries/PGreece.txt"
GAL = "countries/Galileo.txt"
ASM = "countries/Nekokult.txt"
KOL = "countries/Kolyma.txt"
SHM = "countries/Shambala.txt"
HAZ = "countries/Hazaria.txt"
ZHE = "countries/Zheltye.txt"
SIN = "countries/Sinie.txt"
CDR = "countries/ChatDemocraticRepublic.txt"
CCO = "countries/ChatCommuna.txt"
DGC = "countries/DemocraticStateChat.txt"
VTC = "countries/VolnoyeTsardomChat.txt"
YMT = "countries/Yamantau.txt"
BER = "countries/BolgarskayaEstradnayaRespublica.txt"
MNR = "countries/MongolskayaNarodnayaRespublika.txt"
ZNS = "countries/Zapadnovosib.txt"
JPE = "countries/Japan Empire.txt"
SRU = "countries/Sferouslugia.txt"
CHV = "countries/ChVK.txt"
AZR = "countries/Azerbaijan.txt"
ARM = "countries/Armenia.txt"
GEO = "countries/Georgia.txt"
KYR = "countries/Kyrgyzstan.txt"
TAJ = "countries/Tajikistan.txt"
TMS = "countries/Turkmenistan.txt"
UZB = "countries/Uzbekistan.txt"
POL = "countries/Poland.txt"
HUN = "countries/Hungary.txt"
HRV = "countries/YstashiHorvaty.txt"
ANM = "countries/Anime.txt"
BTS = "countries/Bts.txt"
PRM = "countries/Perm.txt"
YAK = "countries/Yakutia.txt"
URK = "countries/Urkia.txt"
SKT = "countries/Syktyvkar.txt"
SUO = "countries/Suomi.txt"
OSV = "countries/Osvoboditel.txt"
ALI = "countries/AliExpress.txt"
ZZZ = "countries/Nichto.txt"
KLG = "countries/Kaliningrad.txt"
GLA = "countries/GlobalLiberationArmy.txt"
GOM = "countries/Gomindan.txt"
ZCH = "countries/RepublicanChina.txt"
PUE = "countries/Puerists.txt"
ZHR = "countries/Zheltorussia.txt"
DRC = "countries/KlonStazi.txt"
CVT = "countries/KlonLoksli.txt"
IRQ = "countries/Iraq.txt"
KUW = "countries/Kuwait.txt"
SAS = "countries/Sasanid.txt"
RES = "countries/RepublicaSalo.txt"
NII = "countries/NewSpainEmpire.txt"
ETR = "countries/Etrusiya.txt"
VNR = "countries/Venetsiya.txt"
AUS	= "countries/Austria.txt"
KRA	= "countries/KriptoArmenia.txt"
EGY = "countries/Egypt.txt"
TUN = "countries/Tunisia.txt"
LBA = "countries/Libya.txt"
LRG = "countries/LibyanRommelGroup.txt"
SWI = "countries/Switzerland.txt"
SWE	= "countries/Sweden.txt"
FRG	= "countries/Germany.txt"
BAV	= "countries/Bavaria.txt"
ZCE	= "countries/Czechoslovakia.txt"
NEU = "countries/NewEurope.txt"
MRH = "countries/Holland.txt"
SFR = "countries/SovkoFrance.txt"
EFR = "countries/EskadronFrance.txt"
LFR = "countries/LiberalFrance.txt"
IZR = "countries/Israel.txt"
NRB = "countries/NRBasques.txt"
GNR = "countries/GaliciaNR.txt"
CNR = "countries/CataloniaNR.txt"
SPE = "countries/SpainEmirat.txt"
CHA = "countries/Gigachad.txt"
SIR = "countries/Syria.txt"
HAL = "countries/Saudi Arabia.txt"
HUS = "countries/Yeman.txt"
DVA = "countries/United Arab Emirates.txt"
EUF	= "countries/Belgium.txt"
PRA = "countries/Portugal.txt"
UGI = "countries/UgItaly.txt"
ARV = "countries/Arab.txt"
TSB = "countries/Iisus.txt"
ZBP = "countries/ZazhitnikiBeloyPlemeni.txt"
KOF = "countries/KeltOchizhFront.txt"
UKE = "countries/UnitedKingdomEngland.txt"
FSK = "countries/FreeScotland.txt"
UBR = "countries/UnitedBritishRepublic.txt"
PBG = "countries/PeakyBlindersGang.txt"
BRS = "countries/Bristol.txt"
SLM = "countries/Slovakia.txt"
CNA = "countries/ChinaNationArmy.txt"
PCH = "countries/PekinChina.txt"
FAL = "countries/Falgun.txt"
TEL = "countries/Tseylon.txt"
RMS = "countries/Romanistan.txt"
AKI = "countries/AriyaKipelova.txt"
IKR = "countries/IduzhieKReke.txt"
PNE = "countries/PelevinNepal.txt"
NBU = "countries/NewBhutan.txt"
CMG = "countries/Chlenopoklonniki.txt"
NAK = "countries/Naksality.txt"
BLD = "countries/Boliwood.txt"
ECP = "countries/EuropeanCommissariatPolen.txt"
COJ = "countries/ComJapan.txt"
ASR = "countries/AumSenrike.txt"
SKV = "countries/SousKorpVituber.txt"
PRJ = "countries/PravJP.txt"
KHA = "countries/Khakassia.txt"
ALT = "countries/Altay.txt"
TAN = "countries/Tannu Tuva.txt"
NEN = "countries/Nenetsia.txt"
IDU = "countries/Udel Ural.txt"
POT = "countries/Potanin.txt"
ZKR = "countries/KedriRussia.txt"
ZKL = "countries/ZelKlin.txt"
TLM = "countries/TatarLiveMatter.txt"
URL = "countries/UralRepublic.txt"
GHM = "countries/HantyMansi.txt"
ING = "countries/Ingria.txt"
PSO = "countries/Pskov.txt"
NOV = "countries/Novgorod.txt"
POM = "countries/Pomorland.txt"
ASI = "countries/AsgardIriyskiy.txt"
LTV = "countries/Latvia.txt"